10 20 5
####################
#S...........#j..$.#    
####T#.#.....#T###.#
#..$.K.#.....G.....#
#g######.....#######
###...#..#...C..$..#
#a#kT...##...#####.#
#..######....A...#.#
#T$..J.......##Tc#E#
####################
